00 00 00 00 00 00 00 00 00 00 00 00 00 00 00 00 00 00 00 00
00 00 00 00 00 00 00 00 00 00 00 00 00 00 00 00 00 00 00 00
00 00 00 00 00 00 00 06 00 00 00 00 00 04 05 02 00 00 00 00
00 00 00 00 00 00 60 60 60 00 00 00 60 60 60 60 60 60 00 00
00 00 00 00 00 00 00 00 00 00 00 00 00 00 00 00 00 00 00 00
00 00 00 00 00 00 00 00 00 00 00 00 00 00 00 03 00 00 00 00
00 00 00 00 00 00 00 00 00 00 00 00 00 00 60 60 60 60 60 00
00 00 00 00 00 00 00 00 01 00 02 00 00 00 60 60 60 60 60 00
62 62 62 62 62 62 62 62 62 62 62 62 62 62 62 62 62 62 62 00
62 62 62 62 62 62 62 62 62 62 62 62 62 62 62 62 62 62 62 62