00 00 00 00 00 00 00 00 00 00 00 00 00 00 00 00 00 00 00 00
00 00 00 00 00 00 00 00 00 00 00 00 00 00 00 00 00 00 00 00
00 00 00 00 00 00 00 00 00 00 00 00 00 00 00 00 00 00 00 00
00 00 00 00 00 00 00 00 00 00 00 00 54 54 54 54 54 54 00 00
00 00 00 00 00 00 00 00 00 00 00 00 00 00 00 00 00 00 00 00
00 00 00 00 00 00 00 00 00 00 00 00 00 00 00 00 00 00 00 00
00 00 00 00 00 00 00 00 00 00 00 00 00 00 54 31 32 32 32 00
00 00 00 00 00 00 00 00 00 00 00 00 00 00 54 49 50 50 50 00
56 56 56 56 56 56 56 56 56 56 56 56 56 56 56 56 56 56 56 00
56 56 56 56 56 56 56 56 56 56 56 56 56 56 56 56 56 56 56 56